"総   数",74,30,15,45,21,8,29
15歳未満,0,0,0,0,0,0,0
15~19歳,0,0,0,0,0,0,0
20~24歳,1,0,0,0,1,0,1
25~29歳,0,0,0,0,0,0,0
30~34歳,0,0,0,0,0,0,0
35~39歳,0,0,0,0,0,0,0
40~44歳,2,0,0,0,1,1,2
45~49歳,6,4,0,4,2,0,2
50~54歳,5,3,0,3,1,1,2
55~59歳,3,2,0,2,1,0,1
60~64歳,4,3,0,3,1,0,1
65~69歳,7,5,2,7,0,0,0
70~74歳,10,6,2,8,2,0,2
75~79歳,13,4,4,8,3,2,5
80~84歳,14,1,4,5,6,3,9
85歳以上,9,2,3,5,3,1,4
